43 43 1
#######         ###################
#..s..#         #%.......%#.......#
#.....# #########...h.....#.......#
#..@..# #...s.............#...p...#
#..s..# #.......#.........#.......#########
#.....# #..g....#.........#....s..........#
#####.# #.......#.........#.......#.......#
#.....# #.......#%.......%#.......#...K...#
#.#######.......###############.###.......#
#..s...............|....|.#.....# #.......#
#.#####.#######.#.........#.....# #####.#.#
#.............#.#....|....#.....#     #...#
###.........#.#.#...|.....#.....#     #####
  #....s....#...#......|..#.....#
  #.........#####..|......###.#############
  #.........#   #...............#....|||.K#
#####.###.#########.#######.....#......|..#
#.....# #.........#.....# #..B...........|#
#.....###.........#####.###.....#....s..||#
#..%....#.........#   #...#.....#.........#
#.....#.#....s....#######.#.#####....g....#
#.....#.#.........#.......#...# #.........#
#######.#....p....#.......###.###.........#
#.......#.........#...s...###........h....#
#.#######.........#.......#################
#.......#.....h...#.......#   #.........#
#####.#.###############.#######.....h...#
#B....#.#       #.......#.....#.........#
#.....#.#########.......#.....#....S....#
#.....#.........#..g..........#.........#
#.....#####.###.#.......#.....#.........#
#...........#...#.......#.....#.........#
#######.....#.#########.#.#####.#########
      #.....#.# #.....#.......#.........#
      #.....#.###.....#.......#.#######.#
      #.....#...#.....#.......#.....# #.#
#######.###.###.#.....#...p...#.....###.#
#.......#.............#.......#.........#
#..g....#.......#######.......#.....#.###
#............h..#     #.......#.....#.#
#.......#.......#     ###############.#
#.......#.......#           #.........#
#################           ###########